datum,pozitivne osobe,pozitivne osobe kumulativno,učinjeni testovi,učinjeni testovi kumulativno,hospitalizirani u zadnja 24 sata,ukupno hospitaliziranih,na respiratoru u zadnja 24 sata,ukupno na respiratoru,preminuli u bolnici,preminuli u bolnici kumulativno
15/04/2020,38,1779,1422,25981,8,341,0,31,3,31
16/04/2020,34,1813,1475,27456,22,372,1,31,2,33
17/04/2020,12,1825,1304,28760,28,372,1,30,1,35
18/04/2020,34,1859,1563,30323,4,361,0,27,2,37
19/04/2020,23,1882,1014,31337,10,331,3,24,8,45
20/04/2020,18,1900,1249,32586,9,324,0,18,1,46
21/04/2020,28,1928,1646,34232,10,317,4,18,1,47
22/04/2020,53,1981,1624,35856,22,314,3,19,0,47
23/04/2020,19,2000,1625,37481,23,321,3,19,2,49
24/04/2020,15,2015,1492,38973,24,325,4,21,1,50
25/04/2020,14,2029,660,39633,7,316,2,21,3,53
26/04/2020,11,2040,681,40314,7,314,2,23,0,53
27/04/2020,3,2043,1533,41847,2,303,0,21,5,58
28/04/2020,12,2055,1497,43344,6,287,3,21,4,62
29/04/2020,19,2074,1636,44980,3,269,1,19,4,66
30/04/2020,11,2085,1538,46518,4,261,2,20,2,68
01/05/2020,3,2088,640,47158,6,245,0,17,6,74
02/05/2020,7,2095,1181,48339,3,239,2,17,2,76
03/05/2020,8,2103,897,49236,0,231,0,15,2,78
04/05/2020,9,2112,1405,50641,2,228,1,15,1,79
05/05/2020,7,2119,1844,52485,5,217,1,14,3,82
06/05/2020,8,2127,1565,54050,4,206,1,14,2,84
07/05/2020,22,2149,1556,55606,3,195,0,13,1,85
08/05/2020,24,2173,1565,57171,11,184,1,13,0,85
09/05/2020,10,2183,1395,58566,13,181,1,13,1,86
10/05/2020,14,2197,1030,59596,2,169,0,13,3,89
11/05/2020,8,2205,1760,61356,2,160,0,12,1,90
12/05/2020,8,2213,1875,63231,5,159,0,11,0,90
13/05/2020,5,2218,1876,65107,2,150,2,9,3,93
14/05/2020,5,2223,1390,66497,3,146,0,7,0,93
15/05/2020,1,2224,1807,68304,2,142,1,8,1,94
16/05/2020,3,2227,1363,69667,0,137,1,9,0,94
17/05/2020,1,2228,964,70631,1,130,2,10,0,94
18/05/2020,1,2229,1984,72615,1,122,0,10,0,94
19/05/2020,6,2235,1586,74201,6,120,2,10,1,95
20/05/2020,3,2238,1577,75778,2,117,0,9,0,95
21/05/2020,6,2244,1393,77171,2,117,0,9,0,95
22/05/2020,0,2244,1198,78369,4,102,0,5,2,97
23/05/2020,0,2244,1094,79463,0,84,1,6,0,97
24/05/2020,1,2245,891,80354,0,81,0,6,0,97
25/05/2020,0,2245,1316,81670,0,78,0,6,0,97
26/05/2020,0,2245,1282,82952,0,42,0,5,2,99
27/05/2020,1,2246,777,83729,0,38,1,6,0,99
28/05/2020,0,2246,615,84344,0,34,0,6,0,99
29/05/2020,1,2247,703,85047,0,28,0,4,2,101
30/05/2020,0,2247,356,85403,1,27,0,4,0,101
31/05/2020,0,2247,317,85720,0,23,0,4,0,101
01/06/2020,0,2247,625,86345,0,22,0,4,0,101
02/06/2020,0,2247,626,86971,0,17,0,4,0,101
03/06/2020,0,2247,462,87433,0,17,0,4,0,101
04/06/2020,1,2248,394,87827,0,15,0,3,0,101
05/06/2020,0,2248,407,88234,0,12,0,3,0,101
06/06/2020,0,2248,181,88415,0,10,0,1,1,102
07/06/2020,0,2248,102,88517,0,10,0,2,0,102
08/06/2020,0,2248,450,88967,0,10,0,2,0,102
09/06/2020,1,2249,383,89350,0,6,0,0,2,104
10/06/2020,1,2250,371,89721,1,7,0,0,0,104
11/06/2020,0,2250,146,89867,1,7,0,0,0,104
12/06/2020,2,2252,449,90316,0,6,0,0,1,105
13/06/2020,1,2253,210,90526,0,6,0,0,0,105
14/06/2020,0,2253,121,90647,1,7,0,0,0,105
15/06/2020,3,2256,447,91094,0,7,0,0,0,105
16/06/2020,3,2259,325,91419,0,4,0,0,0,105
17/06/2020,7,2266,401,91820,1,5,0,0,0,105
18/06/2020,10,2276,447,92267,4,9,0,0,0,105
19/06/2020,17,2293,590,92857,0,8,0,0,0,105
20/06/2020,20,2313,362,93219,0,8,0,0,0,105
21/06/2020,16,2329,338,93557,1,9,0,0,0,105
22/06/2020,32,2361,428,93985,1,9,0,0,0,105
23/06/2020,24,2385,929,94914,8,16,0,0,0,105
24/06/2020,71,2456,1084,95998,4,18,0,0,0,105
25/06/2020,53,2509,1017,97015,10,42,0,0,0,105
26/06/2020,76,2585,1535,98550,16,51,0,0,0,105
27/06/2020,94,2679,822,99372,6,54,0,0,0,105
28/06/2020,50,2729,612,99984,12,60,0,0,0,105
29/06/2020,32,2761,1430,101414,5,65,1,1,0,106
30/06/2020,56,2817,1521,102935,12,75,1,2,0,106
01/07/2020,77,2894,1450,104385,9,80,0,2,1,107
02/07/2020,95,2989,1524,105909,11,84,1,3,2,109
03/07/2020,92,3081,1756,107665,9,88,1,4,2,111
04/07/2020,68,3149,1273,108938,8,85,0,3,1,112
05/07/2020,63,3212,662,109600,13,93,1,4,0,112
06/07/2020,49,3261,2017,111617,9,90,1,5,0,112
07/07/2020,60,3321,1771,113388,5,89,0,5,0,112
08/07/2020,67,3388,2227,115615,8,91,0,4,1,113
09/07/2020,119,3507,1787,117402,20,100,0,3,1,114
10/07/2020,163,3670,1774,119176,13,104,1,4,2,116
11/07/2020,73,3743,1486,120662,26,124,1,3,1,117
12/07/2020,73,3816,865,121527,14,132,0,3,1,118
13/07/2020,57,3873,2251,123778,17,132,1,4,0,118
14/07/2020,82,3955,2587,126365,8,129,1,5,1,119
15/07/2020,70,4025,2215,128580,8,132,2,5,0,119
16/07/2020,79,4104,1943,130523,16,136,1,6,0,119
17/07/2020,139,4243,2045,132568,15,137,1,7,0,119
18/07/2020,101,4344,1543,134111,16,139,3,8,0,119
19/07/2020,25,4369,920,135031,20,153,1,9,0,119
20/07/2020,38,4407,2406,137437,7,147,0,9,2,121
21/07/2020,99,4506,2235,139672,11,138,2,9,1,122
22/07/2020,79,4585,2247,141919,19,143,1,9,2,124
23/07/2020,92,4677,1830,143749,11,132,0,7,3,127
24/07/2020,96,4773,2404,146153,12,139,3,9,0,127
25/07/2020,77,4850,1561,147714,8,134,2,9,5,132
26/07/2020,26,4876,774,148488,14,142,1,9,2,134
27/07/2020,37,4913,2353,150841,4,138,0,9,4,138
28/07/2020,69,4982,1988,152829,10,133,1,9,1,139
29/07/2020,85,5067,2171,155000,11,132,0,8,1,140
30/07/2020,58,5125,1886,156886,10,130,0,6,3,143
31/07/2020,64,5189,2178,159064,9,125,0,6,1,144
01/08/2020,75,5264,1885,160949,18,127,3,9,0,144
02/08/2020,33,5297,758,161707,14,131,1,6,4,148
03/08/2020,19,5316,1975,163682,5,130,0,6,4,152
04/08/2020,63,5379,1852,165534,7,117,1,7,1,153
05/08/2020,25,5404,767,166301,6,111,0,7,0,153
06/08/2020,54,5458,1736,168037,9,110,1,7,1,154
07/08/2020,70,5528,1998,170035,20,122,0,7,0,154
08/08/2020,79,5607,1398,171433,11,120,1,8,2,156
09/08/2020,27,5634,693,172126,6,121,0,8,0,156
10/08/2020,84,5718,2336,174462,8,124,0,8,1,157
11/08/2020,128,5846,1920,176382,5,115,0,5,2,159
12/08/2020,132,5978,2057,178439,7,117,3,8,0,159
13/08/2020,229,6207,1847,180286,8,115,2,10,1,160
14/08/2020,179,6386,2873,183159,7,106,1,10,2,162
15/08/2020,156,6542,1703,184862,22,118,2,11,2,164
16/08/2020,105,6647,1033,185895,13,126,1,11,1,165
17/08/2020,147,6794,3495,189390,4,126,0,11,0,165
18/08/2020,245,7039,3353,192743,12,120,2,11,0,165
19/08/2020,255,7294,3257,196000,19,122,1,11,2,167
20/08/2020,279,7573,3137,199137,11,127,2,13,0,167
21/08/2020,282,7855,3637,202774,11,135,0,12,1,168
22/08/2020,262,8117,2694,205468,17,143,3,12,1,169
23/08/2020,181,8298,1499,206967,24,155,1,12,1,170
24/08/2020,201,8499,3725,210692,16,163,0,12,2,172
25/08/2020,359,8858,3966,214658,25,167,1,9,2,174
26/08/2020,306,9164,4836,219494,26,174,2,10,0,174
27/08/2020,336,9500,5090,224584,37,194,3,13,2,176
28/08/2020,329,9829,4910,229494,33,212,1,11,3,179
29/08/2020,325,10154,3605,233099,24,211,1,12,3,182
30/08/2020,95,10249,1562,234661,28,229,1,13,1,183
31/08/2020,191,10440,4469,239130,28,251,4,14,2,185
01/09/2020,274,10714,5053,244183,31,258,1,14,1,186
02/09/2020,355,11069,4750,248933,33,258,4,15,4,190
03/09/2020,360,11429,4393,253326,33,269,1,15,3,193
04/09/2020,316,11745,4641,257967,41,283,1,15,1,194
05/09/2020,221,11966,3980,261947,41,285,5,19,2,196
06/09/2020,111,12077,1887,263834,27,296,4,21,1,197
07/09/2020,190,12267,5104,268938,24,307,2,19,3,200
08/09/2020,318,12585,4765,273703,35,303,4,23,2,202
09/09/2020,280,12865,4503,278206,33,299,2,24,3,205
10/09/2020,222,13087,3994,282200,42,320,5,27,2,207
11/09/2020,244,13331,4859,287059,31,327,1,26,3,210
12/09/2020,191,13522,4230,291289,36,313,2,24,7,217
13/09/2020,80,13602,1967,293256,18,309,1,22,6,223
14/09/2020,142,13744,5274,298530,17,310,1,22,3,226
15/09/2020,274,14018,5966,304496,20,299,2,22,3,229
16/09/2020,230,14248,4970,309466,30,293,2,20,6,235
17/09/2020,242,14490,4736,314202,34,300,6,24,2,237
18/09/2020,226,14716,5067,319269,17,280,3,21,6,243
19/09/2020,196,14912,3879,323148,35,288,2,24,0,243
20/09/2020,78,14990,2082,325230,18,281,0,21,4,247
21/09/2020,145,15135,5564,330794,30,297,5,24,5,252
22/09/2020,192,15327,5029,335823,28,278,2,24,2,254
23/09/2020,217,15544,4873,340696,34,278,4,27,2,256
24/09/2020,233,15777,4081,344777,23,266,1,24,4,260
25/09/2020,216,15993,4465,349242,31,273,2,22,5,265
26/09/2020,176,16169,3864,353106,37,271,4,25,3,268
27/09/2020,69,16238,1773,354879,22,280,2,23,3,271
28/09/2020,125,16363,5471,360350,16,291,1,24,0,271
29/09/2020,195,16558,4777,365127,34,274,3,26,3,274
30/09/2020,234,16792,4871,369998,37,288,1,23,5,279
01/10/2020,325,17117,4008,374006,31,297,3,26,4,283
02/10/2020,261,17378,4884,378890,40,286,2,23,7,290
03/10/2020,244,17622,3618,382508,41,289,2,23,2,292
04/10/2020,161,17783,1827,384335,33,296,5,25,5,297
05/10/2020,264,18047,5872,390207,45,326,3,24,2,299
06/10/2020,368,18415,5334,395541,52,334,1,24,4,303
07/10/2020,451,18866,5511,401052,52,344,4,26,5,308
08/10/2020,502,19368,4112,405164,49,361,2,27,1,309
09/10/2020,390,19758,5441,410605,58,385,2,28,3,312
10/10/2020,583,20341,4490,415095,52,382,3,29,4,316
11/10/2020,270,20611,1633,416728,31,384,2,26,7,323
12/10/2020,292,20903,6371,423099,42,404,3,27,3,326
13/10/2020,706,21609,6037,429136,54,424,1,27,3,329
14/10/2020,789,22398,6516,435652,64,441,2,27,4,333
15/10/2020,939,23337,5594,441246,72,439,5,26,10,343
16/10/2020,1239,24576,7024,448270,117,505,3,24,1,344
17/10/2020,796,25372,5576,453846,111,530,7,28,8,354
18/10/2020,426,25798,2215,456061,63,548,5,32,8,362
19/10/2020,868,26666,7660,463721,71,571,5,35,11,373
20/10/2020,1589,28255,7807,471528,90,574,0,32,8,381
21/10/2020,1626,29881,8213,479741,117,622,8,38,11,392
22/10/2020,2053,31934,7175,486916,117,661,12,46,14,406
23/10/2020,2294,34228,8991,495907,125,716,8,49,7,412
24/10/2020,2246,36474,7121,503028,148,731,9,52,16,428
25/10/2020,740,37214,2660,505688,153,825,8,58,8,436
26/10/2020,1469,38683,9431,515119,102,864,11,65,15,451
27/10/2020,2526,41209,9463,524582,153,897,3,57,18,469
28/10/2020,2632,43841,8954,533536,155,932,14,68,23,492
29/10/2020,2817,46658,9245,542781,175,985,10,71,18,510
30/10/2020,2789,49447,9750,552531,170,1027,10,74,20,530
31/10/2020,2226,51673,7654,560185,180,1049,14,82,15,545
01/11/2020,1039,52712,2918,563103,149,1097,9,81,16,561
02/11/2020,1411,54123,8917,572020,131,1127,16,94,32,593
03/11/2020,2399,56522,9852,581872,173,1192,25,112,34,627
04/11/2020,2923,59445,8901,590773,190,1221,16,118,26,653
05/11/2020,2802,62247,8891,599664,201,1278,15,122,29,682
06/11/2020,2436,64683,9701,609365,174,1307,23,135,34,716
07/11/2020,2868,67551,8773,618138,248,1330,15,128,35,751
08/11/2020,1437,68988,2997,621135,183,1396,22,145,43,794
09/11/2020,1241,70229,8991,630126,161,1451,16,142,38,832
10/11/2020,2676,72905,10129,640255,234,1513,20,167,33,865
11/11/2020,3094,75999,10135,650390,213,1545,18,178,28,893
12/11/2020,2952,78951,8315,658705,211,1598,13,178,32,925
13/11/2020,2851,81802,9943,668648,233,1620,18,179,43,968
14/11/2020,2517,84319,7372,676020,249,1655,20,184,38,1006
15/11/2020,1251,85570,3018,679038,214,1710,26,194,43,1048
16/11/2020,1949,87519,9112,688150,166,1816,13,191,33,1081
17/11/2020,2988,90507,10918,699068,257,1827,31,196,31,1112
18/11/2020,3474,93981,5356,704424,266,1878,22,205,38,1150
19/11/2020,2729,96710,9560,713984,202,1944,21,204,49,1200
20/11/2020,3658,100368,11389,725373,279,1992,29,217,57,1256
21/11/2020,3695,104063,8501,733874,239,1981,14,213,47,1303
22/11/2020,1678,105741,3391,737265,198,2031,17,223,49,1352
23/11/2020,2320,108061,10835,748100,169,2060,31,235,45,1397
24/11/2020,3541,111602,10810,758910,265,2093,31,244,47,1444
25/11/2020,3996,115598,11958,770868,288,2136,21,240,56,1500
26/11/2020,4075,119673,10471,781339,275,2171,33,252,51,1551
27/11/2020,4054,123727,11391,792730,301,2240,41,266,48,1599
28/11/2020,3174,126901,7170,799900,280,2221,33,262,55,1654
29/11/2020,1769,128670,3255,803155,225,2273,17,260,57,1711
30/11/2020,2565,131235,11038,814193,260,2358,24,255,74,1785
01/12/2020,3712,134947,11626,825819,342,2351,24,245,75,1860
02/12/2020,4375,139322,11230,837049,328,2408,33,252,55,1915
03/12/2020,4185,143507,10077,847126,333,2501,20,258,48,1963
04/12/2020,3812,147319,11797,858923,332,2527,28,262,68,2031
05/12/2020,3452,150771,7623,866546,332,2514,36,259,70,2101
06/12/2020,1518,152289,3274,869820,265,2543,18,264,72,2173
07/12/2020,2558,154847,11497,881317,254,2629,40,277,59,2232
08/12/2020,4759,159606,13325,894642,343,2660,23,278,65,2297
09/12/2020,4651,164257,12588,907230,377,2703,23,280,69,2366
10/12/2020,4827,169084,11272,918502,358,2754,33,296,53,2419
11/12/2020,4168,173252,12085,930587,361,2802,22,304,64,2484
12/12/2020,3145,176397,7573,938160,383,2792,30,295,78,2561
13/12/2020,987,177384,3142,941302,258,2864,22,295,78,2639
14/12/2020,2416,179800,11556,952858,258,2857,29,306,65,2704
15/12/2020,3487,183287,12034,964892,340,2897,23,304,73,2777
16/12/2020,3723,187010,11417,976309,359,2907,34,294,92,2869
17/12/2020,3379,190389,9965,986274,332,2943,39,287,85,2954
18/12/2020,2855,193244,10640,996914,350,2918,29,294,68,3022
19/12/2020,1900,195144,8662,1005576,287,2873,39,306,78,3100
20/12/2020,642,195786,3205,1008781,241,2976,31,290,76,3177
21/12/2020,1681,197467,10244,1019025,206,2956,33,294,80,3256
22/12/2020,2682,200149,9886,1028911,291,2895,30,292,71,3327
23/12/2020,2473,202622,8303,1037214,273,2843,24,291,66,3393
24/12/2020,1489,204111,5646,1042860,281,2749,29,292,70,3463
25/12/2020,248,204359,1068,1043928,259,2662,19,280,84,3547
26/12/2020,635,204994,4058,1047986,176,2664,9,271,65,3613
27/12/2020,302,205296,2194,1050180,199,2691,20,258,58,3670
28/12/2020,1328,206624,7707,1057887,157,2720,32,256,68,3738
29/12/2020,1907,208531,7542,1065429,247,2654,26,254,56,3794
30/12/2020,2519,211050,7966,1073395,345,2608,20,240,65,3859
31/12/2020,1041,212091,4924,1078319,253,2524,26,231,60,3919
01/01/2021,187,212278,1166,1079485,241,2478,17,232,41,3960
02/01/2021,753,213031,6078,1085563,105,2437,12,219,55,4015
03/01/2021,316,213347,2310,1087873,172,2453,17,211,56,4072
04/01/2021,1071,214418,7195,1095068,128,2453,11,196,54,4125
05/01/2021,1973,216391,9436,1104504,217,2390,25,200,53,4178
06/01/2021,473,216864,2701,1107205,182,2264,26,209,44,4222
07/01/2021,1177,218041,6958,1114163,144,2284,16,200,43,4265
08/01/2021,1363,219404,8888,1123051,215,2251,15,194,38,4303
09/01/2021,657,220061,7314,1130365,172,2084,20,191,38,4341
10/01/2021,162,220223,2165,1132530,145,2131,11,193,26,4368
11/01/2021,789,221012,7637,1140167,131,2140,17,191,35,4402
12/01/2021,1184,222196,7631,1147798,186,2048,20,185,43,4445
13/01/2021,934,223130,6610,1154408,161,1993,18,193,26,4471
14/01/2021,710,223840,5379,1159787,147,1921,12,176,45,4516
15/01/2021,746,224586,5967,1165754,137,1855,18,160,33,4549
16/01/2021,415,225001,5004,1170758,124,1760,12,154,38,4587
17/01/2021,145,225146,1768,1172526,86,1761,9,147,28,4616
18/01/2021,536,225682,6902,1179428,90,1742,14,139,39,4654
19/01/2021,889,226571,6646,1186074,157,1713,16,149,29,4683
20/01/2021,787,227358,5737,1191811,120,1603,11,151,27,4710
21/01/2021,621,227979,4729,1196540,122,1562,9,136,27,4737
22/01/2021,611,228590,5033,1201573,105,1518,18,145,32,4769
23/01/2021,361,228951,4402,1205975,129,1468,12,142,29,4798
24/01/2021,106,229057,1739,1207714,97,1474,7,138,28,4827
25/01/2021,469,229526,6805,1214519,77,1485,15,138,32,4858
26/01/2021,843,230369,6851,1221370,123,1491,18,139,23,4881
27/01/2021,612,230981,5892,1227262,110,1381,8,135,31,4912
28/01/2021,562,231543,4860,1232122,98,1326,11,128,30,4942
29/01/2021,546,232089,5358,1237480,99,1286,11,121,29,4971
30/01/2021,353,232442,5224,1242704,116,1249,8,113,26,4998
31/01/2021,85,232527,1797,1244501,92,1275,9,113,29,5026
01/02/2021,401,232928,6937,1251438,65,1288,6,98,27,5053
02/02/2021,717,233645,6909,1258347,121,1258,7,91,17,5070
03/02/2021,573,234218,5995,1264342,99,1222,18,99,17,5087
04/02/2021,490,234708,5003,1269345,98,1196,11,101,18,5105
05/02/2021,431,235139,5634,1274979,100,1203,13,106,16,5121
06/02/2021,276,235415,5412,1280391,106,1143,9,106,22,5143
07/02/2021,72,235487,2094,1282485,57,1142,9,107,25,5169
08/02/2021,274,235761,7185,1289670,42,1137,10,107,29,5197
09/02/2021,595,236356,6836,1296506,76,1082,11,93,26,5223
10/02/2021,370,236726,6170,1302676,62,1055,9,92,14,5237
11/02/2021,360,237086,4834,1307510,86,1029,10,88,25,5262
12/02/2021,383,237469,5386,1312896,82,1007,13,91,19,5281
13/02/2021,222,237691,5243,1318139,69,955,11,89,17,5298
14/02/2021,65,237756,1893,1320032,50,943,9,89,19,5318
15/02/2021,254,238010,7052,1327084,56,951,4,86,21,5338
16/02/2021,503,238513,7074,1334158,90,927,10,84,18,5356
17/02/2021,373,238886,6125,1340283,65,884,6,82,18,5374
18/02/2021,378,239264,4864,1345147,68,829,9,74,24,5398
19/02/2021,430,239694,5600,1350747,67,798,7,73,8,5406
20/02/2021,266,239960,5647,1356394,74,782,10,78,13,5419
21/02/2021,64,240024,2009,1358403,46,789,4,72,9,5429
22/02/2021,347,240371,7442,1365845,44,792,7,68,20,5448
23/02/2021,698,241069,7425,1373270,96,786,8,67,13,5461
24/02/2021,528,241597,6327,1379597,76,791,8,63,15,5476
25/02/2021,515,242112,5030,1384627,80,790,10,70,12,5488
26/02/2021,513,242625,6013,1390640,54,780,10,73,14,5502
27/02/2021,365,242990,6106,1396746,67,760,7,75,8,5510
28/02/2021,91,243081,2153,1398899,47,762,4,67,15,5525
01/03/2021,388,243469,7233,1406132,63,791,9,64,11,5536
02/03/2021,746,244215,7398,1413530,73,770,6,65,11,5547
03/03/2021,674,244889,6791,1420321,83,758,5,68,7,5554
04/03/2021,591,245480,5347,1425668,75,740,7,69,9,5563
05/03/2021,655,246135,5945,1431613,85,744,10,76,6,5569
06/03/2021,394,246529,5798,1437411,76,738,6,72,15,5584
07/03/2021,98,246627,2258,1439669,63,767,4,74,5,5590
08/03/2021,474,247101,8307,1447976,72,805,10,74,19,5608
09/03/2021,976,248077,7391,1455367,90,785,12,78,12,5620
10/03/2021,770,248847,6812,1462179,90,807,6,82,4,5624
11/03/2021,836,249683,5936,1468115,86,811,4,79,10,5634
12/03/2021,816,250499,6181,1474296,75,811,5,78,12,5646
13/03/2021,580,251079,6435,1480731,101,805,8,69,23,5669
14/03/2021,114,251193,2321,1483052,92,855,9,72,7,5677
15/03/2021,696,251889,7745,1490797,56,874,6,72,8,5684
16/03/2021,1443,253332,8610,1499407,109,858,9,78,12,5696
17/03/2021,1189,254521,7594,1507001,112,889,14,84,12,5708
18/03/2021,1120,255641,6394,1513395,104,894,13,84,17,5725
19/03/2021,1211,256852,7010,1520405,101,918,8,80,17,5742
20/03/2021,838,257690,6543,1526948,115,931,15,89,10,5752
21/03/2021,153,257843,2463,1529411,112,982,13,90,20,5773
22/03/2021,931,258774,8683,1538094,92,1033,12,95,13,5785
23/03/2021,1794,260568,9380,1547474,142,1029,12,92,22,5806
24/03/2021,1754,262322,8367,1555841,117,1038,19,99,20,5826
25/03/2021,1809,264131,7827,1563668,139,1071,12,100,10,5836
26/03/2021,1803,265934,8335,1572003,149,1107,20,115,16,5852
27/03/2021,1354,267288,7476,1579479,181,1148,14,121,18,5870
28/03/2021,290,267578,2752,1582231,116,1201,15,121,21,5891
29/03/2021,1440,269018,9918,1592149,112,1247,15,126,18,5909
30/03/2021,2417,271435,10463,1602612,179,1289,16,127,17,5926
31/03/2021,2677,274112,9619,1612231,201,1337,22,144,19,5945
01/04/2021,2357,276469,8674,1620905,182,1390,26,155,20,5965
02/04/2021,2273,278742,7631,1628536,229,1464,16,153,29,5994
03/04/2021,1374,280116,6336,1634872,199,1469,17,158,29,6023
04/04/2021,157,280273,1248,1636120,153,1511,15,158,33,6056
05/04/2021,714,280987,6281,1642401,182,1616,18,156,25,6081
06/04/2021,1664,282651,10092,1652493,205,1713,20,155,30,6111
07/04/2021,3198,285849,11296,1663789,219,1750,28,160,36,6147
08/04/2021,2680,288529,8994,1672783,202,1756,29,171,36,6183
09/04/2021,2512,291041,10582,1683365,223,1768,30,175,50,6233
10/04/2021,1610,292651,8982,1692347,276,1796,25,180,34,6267
11/04/2021,446,293097,2965,1695312,208,1870,18,182,39,6306
12/04/2021,1899,294996,10529,1705841,177,1953,17,191,25,6331
13/04/2021,3143,298139,11265,1717106,246,1948,21,192,25,6356
14/04/2021,2905,301044,10396,1727502,230,1955,24,185,41,6397
15/04/2021,2702,303746,8777,1736279,250,1988,18,179,43,6440
16/04/2021,2596,306342,9125,1745404,227,2003,25,186,44,6484
17/04/2021,1615,307957,7575,1752979,267,2014,22,182,37,6521
18/04/2021,396,308353,2708,1755687,221,2105,29,194,39,6560
19/04/2021,2086,310439,10022,1765709,207,2179,21,199,39,6599
20/04/2021,3035,313474,10510,1776219,288,2198,29,213,42,6641
21/04/2021,2941,316415,10096,1786315,254,2201,32,230,49,6690
22/04/2021,2556,318971,8929,1795244,259,2229,22,226,46,6736
23/04/2021,2547,321518,9393,1804637,255,2227,37,221,46,6782
24/04/2021,1255,322773,6969,1811606,255,2214,18,224,31,6813
25/04/2021,404,323177,3165,1814771,199,2288,34,240,39,6852
26/04/2021,1808,324985,10770,1825541,182,2315,37,259,51,6903
27/04/2021,2883,327868,11622,1837163,264,2263,29,261,52,6955
28/04/2021,2437,330305,10021,1847184,253,2278,32,253,44,6999
29/04/2021,2015,332320,9328,1856512,215,2239,21,245,39,7038
30/04/2021,2064,334384,11519,1868031,221,2237,31,253,41,7079
01/05/2021,954,335338,7559,1875590,245,2210,23,246,49,7128
02/05/2021,333,335671,3495,1879085,158,2223,23,240,52,7180
03/05/2021,1394,337065,9474,1888559,140,2247,23,244,36,7216
04/05/2021,2472,339537,10244,1898803,205,2169,40,259,46,7262
05/05/2021,1616,341153,8496,1907299,194,2123,18,246,51,7313
06/05/2021,1419,342572,7560,1914859,217,2106,25,236,40,7353
07/05/2021,1338,343910,8051,1922910,177,2079,35,242,33,7386
08/05/2021,698,344608,7260,1930170,175,2016,21,235,36,7422
09/05/2021,221,344829,2867,1933037,137,2032,30,278,45,7467
10/05/2021,859,345688,8665,1941702,136,2033,17,229,34,7501
11/05/2021,1479,347167,8709,1950411,166,1928,18,217,46,7547
12/05/2021,1077,348244,7815,1958226,182,1876,24,215,40,7587
13/05/2021,914,349158,6272,1964498,158,1837,14,202,34,7621
14/05/2021,813,349971,7168,1971666,126,1752,21,207,41,7662
15/05/2021,461,350432,6967,1978633,136,1684,11,185,23,7685
16/05/2021,124,350556,2576,1981209,88,1675,12,181,21,7706
17/05/2021,503,351059,8332,1989541,64,1662,15,173,30,7736
18/05/2021,999,352058,8128,1997669,112,1566,14,166,27,7763
19/05/2021,691,352749,6996,2004665,128,1508,16,163,27,7790
20/05/2021,527,353276,5801,2010466,93,1416,14,148,36,7826
21/05/2021,519,353795,6480,2016946,91,1331,5,131,28,7854
22/05/2021,248,354043,5959,2022905,82,1217,11,123,27,7881
23/05/2021,80,354123,2517,2025422,64,1202,12,123,20,7901
24/05/2021,319,354442,7751,2033173,64,1211,8,116,26,7927
25/05/2021,569,355011,7060,2040233,94,1109,8,109,21,7948
26/05/2021,381,355392,6402,2046635,74,1034,10,102,21,7969
27/05/2021,319,355711,5314,2051949,61,968,7,95,10,7979
28/05/2021,321,356032,5674,2057623,61,904,8,95,11,7990
29/05/2021,174,356206,5753,2063376,63,819,8,88,10,8000
30/05/2021,41,356247,2217,2065593,42,809,14,87,13,8013
31/05/2021,210,356457,6618,2072211,23,797,7,84,12,8024
01/06/2021,423,356880,5600,2077811,51,753,5,82,8,8036
02/06/2021,279,357159,5921,2083732,52,709,6,81,8,8044
03/06/2021,83,357242,2564,2086296,44,653,3,66,14,8058
04/06/2021,218,357460,5704,2092000,32,649,9,63,12,8070
05/06/2021,167,357627,5154,2097154,49,598,9,57,13,8082
06/06/2021,39,357666,2103,2099257,17,579,4,55,6,8088
07/06/2021,166,357832,6563,2105820,35,596,4,49,6,8090
08/06/2021,277,358109,5841,2111661,37,545,4,51,5,8094
09/06/2021,176,358285,5289,2116950,30,520,6,51,7,8101
10/06/2021,141,358426,4211,2121161,33,482,2,48,7,8108
11/06/2021,120,358546,4849,2126010,32,456,6,44,13,8121
12/06/2021,59,358605,4694,2130704,21,408,4,35,9,8130
13/06/2021,13,358618,1868,2132572,17,406,5,35,7,8137
14/06/2021,88,358706,5809,2138381,17,404,2,26,13,8150
15/06/2021,145,358851,5306,2143687,24,372,7,28,8,8158
16/06/2021,88,358939,5013,2148700,26,349,5,28,2,8160
17/06/2021,111,359050,4377,2153077,31,342,3,25,3,8163
18/06/2021,89,359139,4890,2157967,18,313,2,25,3,8166
19/06/2021,53,359192,3968,2161935,25,291,2,24,1,8167
20/06/2021,11,359203,1868,2163803,18,288,5,25,5,8172
21/06/2021,79,359282,5215,2169018,14,282,4,19,8,8180
22/06/2021,43,359325,2084,2171102,13,253,1,16,6,8186
23/06/2021,99,359424,5287,2176389,11,251,2,18,2,8188
24/06/2021,111,359535,3767,2180156,18,241,2,15,2,8190
25/06/2021,84,359619,3773,2183929,13,209,1,13,4,8194
26/06/2021,46,359665,4249,2188178,20,208,1,13,1,8195
27/06/2021,13,359678,1973,2190151,5,196,0,11,3,8202
28/06/2021,72,359750,5600,2195751,11,195,0,10,2,8200
29/06/2021,135,359885,4903,2200654,16,181,3,11,3,8203
30/06/2021,98,359983,4526,2205180,13,159,4,12,1,8204
01/07/2021,93,360076,4032,2209212,12,151,1,13,3,8207
02/07/2021,109,360185,3672,2212884,10,139,0,13,3,8210
03/07/2021,56,360241,3664,2216548,11,131,7,11,3,8213
04/07/2021,9,360250,1822,2218370,12,141,1,10,3,8216
05/07/2021,96,360346,4936,2223306,11,140,3,11,1,8217
06/07/2021,138,360484,4466,2227772,16,132,4,10,2,8219
07/07/2021,109,360593,4083,2231855,17,122,4,6,3,8222
08/07/2021,85,360678,3452,2235307,11,121,0,3,3,8224
09/07/2021,91,360769,3783,2239090,9,115,0,4,0,8224
10/07/2021,54,360823,3427,2242517,13,105,2,5,1,8225
11/07/2021,16,360839,1700,2244217,3,106,4,8,0,8225
12/07/2021,90,360929,4504,2248721,6,107,1,8,2,8227
13/07/2021,157,361086,3921,2252642,12,106,1,9,2,8229
14/07/2021,140,361226,3838,2256480,17,111,0,8,2,8231
15/07/2021,127,361353,3742,2260222,13,110,3,9,0,8231
16/07/2021,145,361498,3850,2264072,13,112,4,12,1,8232
17/07/2021,106,361604,3471,2267543,12,130,0,12,2,8234
18/07/2021,21,361625,1624,2269167,15,121,1,12,2,8236
19/07/2021,142,361767,4505,2273672,10,125,2,17,2,8238
20/07/2021,194,361961,4263,2277935,15,121,0,11,3,8241
21/07/2021,175,362136,3907,2281842,11,122,3,13,1,8242
22/07/2021,183,362319,4997,2286839,14,124,1,14,1,8243
23/07/2021,208,362527,7721,2294560,15,128,4,17,0,8243
24/07/2021,115,362642,7617,2302177,10,121,1,15,0,8243
25/07/2021,33,362675,3868,2306045,18,137,1,13,0,8243
26/07/2021,173,362848,7298,2313343,12,138,0,13,2,8245
27/07/2021,199,363047,6709,2320052,21,143,1,13,0,8245
28/07/2021,200,363247,6839,2326891,19,143,0,11,2,8247
29/07/2021,169,363416,7200,2334091,18,149,3,12,1,8248
30/07/2021,222,363638,8275,2342366,25,154,1,12,4,8252
31/07/2021,139,363777,8782,2351148,23,150,5,11,5,8257
01/08/2021,36,363813,4730,2355878,8,150,2,12,4,8261
02/08/2021,186,363999,7278,2363156,14,156,2,13,4,8265
03/08/2021,280,364279,7747,2370903,20,149,1,11,1,8266
04/08/2021,248,364527,8916,2379819,22,153,2,12,0,8266
05/08/2021,102,364629,5728,2385547,15,154,2,14,3,8269
06/08/2021,240,364869,8857,2394404,15,163,5,16,0,8269
07/08/2021,214,365083,7865,2402269,30,166,2,18,1,8270
08/08/2021,41,365124,4320,2406589,30,166,2,18,1,8271
09/08/2021,252,365376,8578,2415167,26,190,5,22,0,8271
10/08/2021,386,365762,8279,2423446,26,189,2,17,2,8273
11/08/2021,342,366104,8656,2432102,26,196,5,21,0,8273
12/08/2021,305,366409,8679,2440781,22,192,2,19,3,8276
13/08/2021,357,366766,10964,2451745,27,199,2,21,2,8278
14/08/2021,303,367069,9083,2460828,28,192,3,21,2,8280
15/08/2021,45,367114,3250,2464078,20,192,2,21,1,8281
16/08/2021,351,367465,10417,2474495,28,212,3,24,2,8283
17/08/2021,520,367985,10436,2484931,39,220,4,26,3,8286
18/08/2021,484,368469,8428,2493359,43,235,5,26,3,8289
19/08/2021,480,368949,9594,2502953,32,244,3,25,3,8292
20/08/2021,494,369443,13004,2515957,31,251,2,26,1,8293
21/08/2021,366,369809,11444,2527401,37,269,9,34,3,8296
22/08/2021,76,369885,5039,2532440,31,275,2,35,3,8299
23/08/2021,480,370365,10788,2543228,45,307,7,42,2,8301
24/08/2021,717,371082,12527,2555755,56,330,7,44,3,8304
25/08/2021,628,371710,9973,2565728,64,356,8,46,3,8307
26/08/2021,579,372289,10108,2575836,41,378,7,43,6,8313
27/08/2021,593,372882,12097,2587933,47,372,6,47,2,8315
28/08/2021,426,373308,10720,2598653,47,374,6,43,7,8322
29/08/2021,97,373405,3951,2602604,38,387,8,49,1,8323
30/08/2021,669,374074,9403,2612007,52,427,7,55,6,8337
31/08/2021,873,374947,10144,2622151,53,423,5,53,3,8340
01/09/2021,793,375740,8694,2630845,58,440,9,59,4,8344
02/09/2021,823,376563,9183,2640028,69,450,6,53,11,8356
03/09/2021,888,377451,12196,2652224,47,457,10,57,6,8362
04/09/2021,526,377977,8070,2660294,72,469,11,59,7,8369
05/09/2021,148,378125,3865,2664159,53,485,2,52,8,8377
06/09/2021,712,378837,10262,2674421,62,518,6,57,5,8382
07/09/2021,1248,380085,10776,2685197,76,518,10,57,10,8392
08/09/2021,909,380994,9204,2694401,68,540,12,62,10,8401
09/09/2021,1054,382048,10436,2704837,65,554,5,58,10,8411
10/09/2021,1147,383195,13189,2718026,55,552,6,59,8,8419
11/09/2021,808,384003,10645,2728671,69,559,9,55,14,8425
12/09/2021,175,384178,4016,2732687,44,572,17,62,13,8438
13/09/2021,1007,385185,10615,2743302,45,592,5,59,7,8445
14/09/2021,1840,387025,10547,2753849,87,600,10,59,9,8454
15/09/2021,1375,388400,11106,2764955,62,603,10,64,7,8461
16/09/2021,1369,389769,11718,2776673,79,628,13,72,9,8470
17/09/2021,1416,391185,12283,2788956,93,651,14,77,9,8479
18/09/2021,863,392048,8693,2797649,79,659,12,80,12,8491
19/09/2021,269,392317,3535,2801184,70,683,7,81,7,8498
20/09/2021,1047,393364,9446,2810630,52,692,12,85,14,8512
21/09/2021,1838,395202,11040,2821670,92,689,10,88,12,8524
22/09/2021,1343,396545,10471,2832141,93,706,11,87,13,8537
23/09/2021,1271,397816,10270,2842411,66,694,11,89,15,8552
24/09/2021,1295,399111,10569,2852980,64,678,9,92,12,8564
25/09/2021,852,399963,8692,2861672,76,661,13,94,14,8578
26/09/2021,207,400170,3229,2864901,64,692,12,99,15,8593
27/09/2021,1072,401242,9326,2874227,61,720,6,97,11,8604
28/09/2021,1963,403205,9881,2884108,105,738,13,102,8,8612
29/09/2021,1714,404919,8909,2893017,92,745,7,99,14,8626
30/09/2021,1497,406416,9515,2902532,76,741,5,94,12,8638
01/10/2021,1450,407866,10275,2912807,78,738,18,99,10,8648
02/10/2021,919,408785,8923,2921730,72,744,15,96,14,8662
03/10/2021,236,409021,3294,2925024,77,779,13,95,14,8676
04/10/2021,1113,410134,9115,2934139,56,810,11,98,7,8683
05/10/2021,1871,412005,11222,2945361,113,822,21,107,19,8703
06/10/2021,1787,413792,9817,2955178,106,820,21,116,18,8721
07/10/2021,1665,415457,9617,2964795,90,823,12,119,8,8729
08/10/2021,1572,417029,9001,2973796,81,805,15,121,22,8751
09/10/2021,911,417940,7230,2981026,111,814,26,125,11,8761
10/10/2021,173,418113,2572,2983598,63,839,14,124,9,8770
11/10/2021,1048,419161,8473,2992071,58,866,18,131,6,8776
12/10/2021,2022,421183,10004,3002075,118,870,15,140,24,8800
13/10/2021,1822,423005,9450,3011525,107,855,12,128,27,8827
14/10/2021,1736,424741,9219,3020744,99,869,9,122,17,8844
15/10/2021,1991,426732,9705,3030449,92,873,9,118,15,8860
16/10/2021,1289,428021,7324,3037773,103,871,17,114,15,8875
17/10/2021,331,428352,2823,3040596,78,903,19,116,19,8905
18/10/2021,1761,430113,8989,3049585,72,945,11,119,11,8905
19/10/2021,3289,433402,11329,3060914,125,947,22,128,21,8926
20/10/2021,2961,436363,10486,3071400,98,939,18,131,23,8949
21/10/2021,3229,439592,10385,3081785,125,975,12,127,17,8966
22/10/2021,3593,443185,11121,3092906,131,997,17,135,17,8983
23/10/2021,2355,445540,7307,3100213,148,1033,21,128,25,9008
24/10/2021,691,446231,2823,3103036,112,1091,20,143,28,9036
25/10/2021,3372,449603,11266,3114302,117,1159,20,143,22,9058
26/10/2021,4639,454242,13539,3127841,159,1170,18,139,30,9088
27/10/2021,4283,458525,12438,3140279,160,1207,23,153,26,9115
28/10/2021,4386,462911,12058,3152337,161,1231,19,160,26,9141
29/10/2021,4476,467387,12249,3164586,167,1311,32,171,26,9167
30/10/2021,3234,470621,7791,3172377,179,1330,20,175,30,9196
31/10/2021,1149,471770,3712,3176089,177,1418,35,170,22,9218
01/11/2021,889,472659,3238,3179327,169,1496,44,183,31,9249
02/11/2021,4352,477011,13189,3192516,194,1543,23,185,40,9289
03/11/2021,6834,483845,16444,3208960,256,1634,29,198,41,9330
04/11/2021,6648,490493,13783,3222743,233,1680,35,219,32,9362
05/11/2021,6790,497283,14707,3237450,307,1711,25,231,36,9398
06/11/2021,4200,501483,9561,3247011,256,1787,28,234,50,9448
07/11/2021,1227,502710,3496,3250507,197,1848,50,248,50,9498
08/11/2021,5213,507923,14356,3264863,173,1888,27,246,46,9544
09/11/2021,7368,515291,17745,3282608,274,1952,30,253,59,9603
10/11/2021,6877,522168,15941,3298549,228,1940,24,254,50,9653
11/11/2021,6352,528520,14659,3313208,260,2008,30,257,66,9719
12/11/2021,6421,534941,14665,3327873,277,2086,22,251,53,9772
13/11/2021,4056,538997,9687,3337560,265,2107,40,269,66,9838
14/11/2021,1080,540077,3558,3341118,199,2219,30,277,41,9879
15/11/2021,4572,544649,14519,3355637,208,2338,36,287,55,9934
16/11/2021,6808,551457,15940,3371577,302,2378,53,289,50,9984
17/11/2021,6858,558315,16291,3387868,302,2433,51,323,64,10048
18/11/2021,2352,560667,4491,3392359,346,2513,41,324,63,10111
19/11/2021,5758,566425,14762,3407121,195,2539,28,327,65,10176
20/11/2021,4225,570650,9796,3416917,297,2542,32,320,65,10241
21/11/2021,1161,571811,3298,3420215,224,2568,31,323,60,10301
22/11/2021,4907,576718,14172,3434387,170,2583,29,324,73,10374
23/11/2021,6479,583197,16062,3450449,291,2591,34,317,62,10436
24/11/2021,6018,589215,14554,3465003,250,2551,29,323,67,10503
25/11/2021,5437,594652,13372,3478375,253,2529,32,316,64,10567
26/11/2021,5496,600148,13002,3491377,257,2496,34,325,75,10643
27/11/2021,3292,603440,8195,3499572,285,2506,34,324,51,10801
28/11/2021,999,604439,3406,3502978,215,2538,27,330,64,10757
29/11/2021,3854,608293,12281,3515259,181,2598,31,308,67,10824
30/11/2021,5764,614057,14751,3530010,236,2512,36,314,73,10897
01/12/2021,5352,619409,13470,3543480,242,2454,36,312,68,10965
02/12/2021,4428,623837,11791,3555271,207,2729,30,311,76,11041
03/12/2021,4502,628339,11958,3567229,211,2400,28,313,53,11094
04/12/2021,2834,631173,7736,3574965,247,2382,34,317,54,11148
05/12/2021,686,631859,2736,3577701,171,2381,20,310,68,11216
06/12/2021,3331,635190,11013,3588714,156,2444,38,326,51,11267
07/12/2021,4841,640031,13663,3602377,269,2436,25,319,60,11327
08/12/2021,4304,644335,12139,3614516,231,2412,27,320,54,11381
09/12/2021,3814,648149,10857,3625373,202,2352,28,321,62,11443
10/12/2021,3984,652133,11432,3636805,203,2329,31,326,71,11514
11/12/2021,2187,654320,7008,3643813,235,2290,30,323,58,11572
12/12/2021,475,654795,2557,3646370,140,2293,44,330,45,11617
13/12/2021,3098,657893,10767,3657137,115,2300,23,326,47,11664
14/12/2021,4661,662554,13187,3670324,192,2253,25,315,56,11720
15/12/2021,4001,666555,11977,3682301,238,2256,26,306,57,11777
16/12/2021,3472,670027,10535,3692836,183,2253,21,286,46,11823
17/12/2021,3542,673569,10743,3703579,192,2188,24,288,54,11877
18/12/2021,1886,675455,6703,3710282,215,2154,25,283,51,11928
19/12/2021,373,675828,2201,3712483,140,2167,18,269,51,11979
20/12/2021,2786,678614,10353,3722836,123,2178,22,268,60,12039
21/12/2021,4259,682873,12375,3735211,197,2148,20,263,47,12088
22/12/2021,3808,686681,10550,3745761,149,2066,29,266,36,12124
23/12/2021,3238,689919,9524,3755285,147,1981,26,266,53,12177
24/12/2021,3242,693161,9140,3764425,145,1893,28,266,53,12230
25/12/2021,176,693337,1108,3765533,145,1807,23,254,46,12277
26/12/2021,585,693922,3069,3768602,119,1824,23,267,46,12323
27/12/2021,4148,698070,12314,3780916,130,1872,13,247,50,12373
28/12/2021,5610,703680,14590,3795506,196,1849,23,238,50,12423
29/12/2021,6130,709810,14129,3809635,191,1868,20,237,41,12464
30/12/2021,5512,715322,13704,3823339,167,1858,19,239,27,12491
31/12/2021,5339,720661,12972,3836311,156,1808,26,237,45,12536
01/01/2022,382,721043,1910,3838221,169,1752,24,226,33,12569
02/01/2022,1138,722181,4889,3843110,108,1755,21,228,38,12607
03/01/2022,5806,727987,16831,3859941,126,1795,25,239,44,12651
04/01/2022,8517,736504,19702,3879643,199,1817,27,233,46,12697
05/01/2022,9256,745760,20477,3900120,178,1841,20,230,32,12729
06/01/2022,3947,749707,6377,3906497,209,1824,36,244,33,12762
07/01/2022,8180,757887,22406,3928903,121,1846,21,245,41,12803
08/01/2022,8022,765909,14323,3943226,208,1820,32,249,36,12839
09/01/2022,1537,767446,4319,3947545,147,1874,15,242,37,12876
10/01/2022,7952,775398,20558,3968103,123,1893,27,244,47,12923
11/01/2022,10062,785460,21306,3989409,165,1824,21,233,44,12967
12/01/2022,8990,794450,19057,4008466,188,1822,13,220,36,13003
13/01/2022,8431,802881,17337,4025803,171,1755,23,216,35,13038
14/01/2022,8961,811842,18258,4044061,163,1710,23,205,32,13070
15/01/2022,5739,817581,11490,4055551,179,1688,33,229,35,13105
16/01/2022,1397,818978,3901,4059452,147,1717,16,224,45,13150
17/01/2022,7880,826858,18950,4078402,135,1763,17,221,39,13189
18/01/2022,10384,837242,21607,4100009,224,1800,20,220,55,13244
19/01/2022,11526,848768,21412,4121421,195,1796,22,204,45,13289
20/01/2022,10544,859312,20157,4141578,230,1792,19,195,43,13332
21/01/2022,10844,870156,21161,4162739,207,1799,13,193,35,13367
22/01/2022,7148,877304,12689,4175428,246,1805,21,199,36,13403
23/01/2022,1805,879109,4483,4179911,169,1860,17,201,36,13439
24/01/2022,8422,887531,20447,4200358,177,1926,18,198,44,13483
25/01/2022,11919,899450,22468,4222826,252,1951,19,200,51,13534
26/01/2022,10444,909894,20145,4242971,279,1976,17,192,64,13598
27/01/2022,9984,919878,18733,4261704,253,2006,22,185,59,13657
28/01/2022,9977,929855,19322,4281026,224,1943,23,187,65,13722
29/01/2022,6179,936034,11944,4292970,246,1936,16,183,41,13763
30/01/2022,1469,937503,3978,4296948,201,2008,17,185,46,13809
31/01/2022,7404,944907,18106,4315054,179,2085,15,184,50,13859
01/02/2022,9935,954842,19196,4334250,246,2052,21,183,66,13925
02/02/2022,8827,963669,17616,4351866,288,2067,19,190,54,13979
03/02/2022,8007,971676,15833,4367699,254,2108,21,194,42,14021
04/02/2022,7642,979318,15552,4383251,253,2126,18,185,46,14067
05/02/2022,4788,984106,9976,4393227,267,2115,24,194,43,14110
06/02/2022,1148,985254,3271,4396498,190,2140,11,178,59,14169
07/02/2022,5491,990745,14304,4410802,171,2191,20,178,57,14226
08/02/2022,7834,998579,16600,4427402,295,2229,23,182,50,14276
09/02/2022,6424,1005003,14031,4441433,218,2188,17,186,37,14313
10/02/2022,5190,1010193,11668,4453101,236,2131,9,173,48,14361
11/02/2022,5124,1015317,11612,4464713,250,2133,22,171,44,14405
12/02/2022,2678,1017995,7316,4472029,256,2092,17,168,51,14456
13/02/2022,453,1018448,2065,4474094,159,2115,13,158,49,14505
14/02/2022,3441,1021889,10275,4484369,116,2097,9,146,64,14569
15/02/2022,5876,1027765,12861,4497230,201,2026,15,138,47,14616
16/02/2022,4401,1032166,10794,4508024,203,1966,19,140,48,14664
17/02/2022,3695,1035861,9469,4517493,179,1933,13,132,47,14711
18/02/2022,3389,1039250,9567,4527060,168,1837,5,128,50,14761
19/02/2022,2051,1041301,6358,4533418,159,1707,14,125,44,14805
20/02/2022,294,1041595,1866,4535284,123,1720,12,125,42,14847
21/02/2022,1938,1043533,7889,4543173,93,1698,9,122,54,14901
22/02/2022,3691,1047224,9953,4553126,167,1610,7,113,36,14937
23/02/2022,2476,1049700,7530,4560656,143,1555,7,104,37,14974
24/02/2022,2032,1051732,6250,4566906,137,1504,9,109,22,14996
25/02/2022,1872,1053604,5562,4572468,150,1445,13,106,26,15022
26/02/2022,1028,1054632,4456,4576924,131,1389,11,104,22,15044
27/02/2022,205,1054837,1547,4578471,56,1381,11,106,18,15062
28/02/2022,1162,1055999,5883,4584354,71,1363,10,98,39,15101
01/03/2022,2568,1058567,7599,4591953,104,1266,9,91,32,15133
02/03/2022,1562,1060129,5972,4597925,96,1183,7,92,21,15154
03/03/2022,1349,1061478,4891,4602816,77,1130,5,81,23,15177
04/03/2022,1487,1062965,5060,4607876,75,1053,6,74,27,15204
05/03/2022,891,1063856,3957,4611833,87,971,6,72,22,15226
06/03/2022,159,1064015,1321,4613154,58,966,4,74,20,15246
07/03/2022,1052,1065067,5656,4618810,54,967,7,69,20,15266
08/03/2022,2589,1067656,7700,4626510,81,930,5,61,16,15282
09/03/2022,1692,1069348,5947,4632457,72,853,10,59,26,15308
10/03/2022,1604,1070952,5916,4638373,87,821,4,57,18,15326
11/03/2022,1522,1072474,5468,4643841,81,819,7,65,14,15340
12/03/2022,943,1073417,4332,4648173,68,745,3,53,13,15353
13/03/2022,143,1073560,1413,4649586,51,764,1,49,15,15368
14/03/2022,1203,1074763,6027,4655613,49,774,5,51,18,15386
15/03/2022,2677,1077440,8258,4663871,74,715,1,47,19,15405
16/03/2022,1990,1079430,6803,4670674,86,712,2,44,10,15415
17/03/2022,1990,1081420,6411,4677085,66,696,3,42,9,15424
18/03/2022,1770,1083190,5669,4682754,73,691,3,39,18,15442
19/03/2022,1012,1084202,4184,4686938,67,650,5,42,15,15457
20/03/2022,132,1084334,1393,4688331,53,661,6,44,10,15467
21/03/2022,1263,1085597,6146,4694477,45,677,4,40,16,15483
22/03/2022,2224,1087821,7626,4702103,75,654,4,42,12,15495
23/03/2022,1978,1089799,6324,4708427,77,633,5,43,13,15508
24/03/2022,1746,1091545,5581,4714008,77,631,3,41,9,15517
25/03/2022,1595,1093140,5054,4719062,66,628,7,43,10,15527
26/03/2022,945,1094085,4151,4723213,90,613,3,41,14,15541
27/03/2022,149,1094234,1448,4724661,57,645,2,40,11,15552
28/03/2022,926,1095160,5242,4729903,48,673,2,36,14,15566
29/03/2022,2352,1097512,7138,4737041,88,664,6,35,14,15580
30/03/2022,1714,1099226,5840,4742881,75,651,4,37,15,15595
31/03/2022,1445,1100671,5035,4747916,76,636,2,37,12,15607
01/04/2022,1300,1101971,4708,4752624,83,657,5,40,9,15616
02/04/2022,815,1102786,3848,4756472,69,623,6,40,8,15624
03/04/2022,88,1102874,1228,4757700,53,648,4,38,9,15633
04/04/2022,840,1103714,5456,4763156,31,649,2,36,18,15651
05/04/2022,1687,1105401,6203,4769359,60,619,2,34,15,15666
06/04/2022,1222,1106623,5110,4774469,57,596,3,26,12,15678
07/04/2022,1086,1107709,4265,4778734,63,591,2,25,6,15684
08/04/2022,912,1108621,3766,4782500,56,564,3,28,8,15692
09/04/2022,524,1109145,3073,4785573,70,532,3,27,15,15707
10/04/2022,83,1109228,1116,4786689,37,525,1,25,10,15717
11/04/2022,642,1109870,4747,4791436,35,542,4,26,9,15726
12/04/2022,1160,1111030,4641,4796077,66,551,3,27,8,15734
13/04/2022,810,1111840,3651,4799728,42,541,3,27,5,15739
14/04/2022,670,1112510,2890,4802618,50,527,3,24,8,15747
15/04/2022,636,1113146,2475,4805093,50,503,4,24,5,15752
16/04/2022,385,1113531,2153,4807246,61,478,4,25,5,15757
17/04/2022,33,1113564,554,4807800,31,477,1,24,10,15767
18/04/2022,126,1113690,2087,4809887,29,478,0,23,7,15774
19/04/2022,500,1114190,4279,4814166,40,505,1,22,10,15784
20/04/2022,1272,1115462,4829,4818995,90,516,4,20,5,15789
21/04/2022,849,1116311,3696,4822691,57,492,4,23,8,15797
22/04/2022,898,1117209,3494,4826185,52,479,1,22,7,15804
23/04/2022,549,1117758,3057,4829242,61,455,4,22,6,15810
24/04/2022,73,1117831,1217,4830459,34,455,4,23,4,15814
25/04/2022,714,1118545,4763,4835222,32,465,2,24,8,15822
26/04/2022,1389,1119934,5374,4840596,68,434,4,24,11,15833
27/04/2022,893,1120827,3881,4844477,52,435,2,22,7,15840
28/04/2022,893,1121720,3480,4847957,49,425,2,20,9,15849
29/04/2022,754,1122474,2978,4850935,55,433,0,18,5,15854
30/04/2022,525,1122999,3120,4854055,54,422,2,17,6,15860
01/05/2022,43,1123042,891,4854946,46,437,2,15,7,15867
02/05/2022,574,1123616,4389,4859335,34,441,2,17,8,15875
03/05/2022,1212,1124828,4913,4864248,52,426,3,21,5,15880
04/05/2022,915,1125743,4112,4868360,39,411,3,17,8,15888
05/05/2022,765,1126508,3462,4871822,53,401,3,17,9,15897
06/05/2022,838,1127346,3129,4874951,48,385,1,16,9,15906
07/05/2022,413,1127759,3120,4878071,51,377,2,16,7,15913
08/05/2022,56,1127815,1139,4879210,29,379,4,16,7,15920
09/05/2022,480,1128295,4849,4884059,25,381,1,13,8,15928
10/05/2022,1022,1129317,4791,4888850,47,374,4,15,4,15932
11/05/2022,662,1129979,4214,4893064,48,367,6,17,6,15938
12/05/2022,595,1130574,3249,4896313,43,388,2,17,8,15946
13/05/2022,540,1131114,2979,4899292,26,361,3,17,8,15953
14/05/2022,354,1131468,2995,4902287,33,345,0,15,5,15958
15/05/2022,43,1131511,1165,4903452,25,356,0,15,5,15963
16/05/2022,404,1131915,4435,4907887,27,364,0,15,12,15975
17/05/2022,786,1132701,4177,4912064,33,367,0,13,2,15977
18/05/2022,455,1133156,3348,4915412,25,326,0,11,1,15978
19/05/2022,427,1133583,2718,4918130,18,292,1,11,5,15983
20/05/2022,452,1134035,2328,4920458,20,273,0,9,4,15987
21/05/2022,205,1134240,2583,4923041,31,264,1,6,7,15994
22/05/2022,42,1134282,1069,4924110,17,264,1,5,5,15999
23/05/2022,272,1134554,4102,4928212,16,263,1,5,2,16001
24/05/2022,587,1135141,3869,4932081,19,253,0,5,2,16003
25/05/2022,418,1135559,3174,4935255,21,240,0,5,3,16006
26/05/2022,357,1135916,2496,4937751,25,222,0,5,5,16011
27/05/2022,317,1136233,1934,4939685,24,229,0,4,0,16011
28/05/2022,194,1136427,1743,4941428,17,231,0,4,1,16012
29/05/2022,34,1136461,739,4942167,20,224,3,5,4,16016
30/05/2022,48,1136509,1499,4943666,12,228,0,5,1,16017
31/05/2022,208,1136717,3426,4947092,10,223,1,5,3,16020
01/06/2022,544,1137261,2921,4950013,23,205,0,5,4,16024
02/06/2022,348,1137609,2062,4952075,30,202,2,6,4,16028
03/06/2022,266,1137875,1683,4953758,30,202,2,6,3,16031
04/06/2022,190,1138065,1814,4955572,16,184,2,6,0,16030
05/06/2022,27,1138092,658,4956230,16,190,1,7,0,16030
06/06/2022,194,1138286,2686,4958916,13,186,0,6,5,16035
07/06/2022,426,1138712,2456,4961372,19,178,1,6,1,16036
08/06/2022,329,1139041,2075,4963447,25,168,0,5,3,16039
09/06/2022,283,1139324,1813,4965260,26,175,3,8,5,16044
10/06/2022,289,1139613,1572,4966832,15,165,0,6,2,16046
11/06/2022,207,1139820,1720,4968552,10,158,0,5,2,16048
12/06/2022,20,1139840,794,4969346,8,153,0,5,3,16051
13/06/2022,249,1140089,2668,4972014,12,159,2,6,0,16051
14/06/2022,546,1140635,2107,4974121,19,163,1,7,1,16052
15/06/2022,425,1141060,2024,4976145,13,151,2,7,2,16054
16/06/2022,63,1141123,587,4976732,15,152,1,6,0,16054
17/06/2022,439,1141562,1868,4978600,11,150,1,7,2,16056
18/06/2022,377,1141939,1662,4980262,30,157,1,7,3,16059
19/06/2022,28,1141967,428,4980690,17,160,1,7,3,16062
20/06/2022,421,1142388,2192,4982882,8,167,0,6,1,16063
21/06/2022,857,1143245,3089,4985971,27,174,1,9,4,16067
22/06/2022,129,1143374,914,4986885,32,188,0,4,4,16071
23/06/2022,631,1144005,2310,4989195,33,210,1,5,4,16075
24/06/2022,1056,1145061,2757,4991952,29,229,3,5,4,16079
25/06/2022,449,1145510,2058,4994010,23,210,0,5,1,16080
26/06/2022,35,1145545,514,4994524,20,216,2,6,2,16082
27/06/2022,663,1146208,3121,4997645,20,228,1,7,2,16084
28/06/2022,1256,1147464,3594,5001239,38,233,2,8,7,16091
29/06/2022,1133,1148597,3381,5004620,33,243,1,5,1,16092
30/06/2022,987,1149584,2935,5007555,31,245,0,5,5,16097
01/07/2022,1138,1150722,3023,5010578,46,269,2,7,5,16102
02/07/2022,758,1151480,2500,5013078,42,257,2,8,3,16105
03/07/2022,59,1151539,605,5013683,34,275,0,5,6,16111
04/07/2022,847,1152386,3576,5017259,51,297,2,7,3,16114
05/07/2022,1780,1154166,4713,5021972,55,310,5,11,7,16121
06/07/2022,1488,1155654,4172,5026144,44,312,3,12,4,16125
07/07/2022,1304,1156958,3587,5029731,64,349,4,13,3,16128
08/07/2022,1478,1158436,3851,5033582,49,339,3,12,5,16133
09/07/2022,787,1159223,2603,5036185,49,344,1,13,2,16135
10/07/2022,63,1159286,568,5036753,35,369,0,13,4,16139
11/07/2022,998,1160284,4076,5040829,61,413,2,13,11,16150
12/07/2022,1824,1162108,4873,5045702,71,429,3,13,6,16156
13/07/2022,1772,1163880,4651,5050353,60,442,2,14,6,16162
14/07/2022,1616,1165496,4173,5054526,76,471,5,17,5,16167
15/07/2022,1663,1167159,4339,5058865,64,464,3,14,8,16175
16/07/2022,991,1168150,2952,5061817,71,477,4,16,4,16179
17/07/2022,86,1168236,685,5062502,55,490,5,20,9,16188
18/07/2022,1142,1169378,4308,5066810,51,514,1,18,2,16190
19/07/2022,2249,1171627,5562,5072372,110,547,3,17,11,16201
20/07/2022,1815,1173442,4756,5077128,86,560,2,16,12,16213
21/07/2022,1470,1174912,3851,5080979,74,578,2,15,7,16220
22/07/2022,1670,1176582,4142,5085121,96,609,2,14,10,16230
23/07/2022,1033,1177615,2896,5088017,87,579,5,15,8,16238
24/07/2022,96,1177711,636,5088653,63,595,1,13,11,16249
